,A,B,C,D,E
A,0,1,0,1,1
B,1,0,1,0,1
C,0,1,0,0,1
D,1,0,0,0,1
E,1,1,1,1,0